%%%%%%%%%%%%%%%%%%%%%%%%%%%%%%%%%%%%%%%%%
% G   %                                 %
%   %%%%%%%%%%%%%%%%%%%%%%%%%%%%%%      %
%                                 %     %
% %%%%%        %                  %     %
%     %        %   %%%%%%   %%%%%%%     %
%     %%%%%%%%%%   %              %     %
%      %       %   %              %     %
%      %       %   %              %     %
%      %       %   %%%%%%%%%%%%%%%%     %
%      %       %                  %     %
%              %%%%%%%%%%%%%%%%   %     %
%      %%%%%%           %     %   %     %
%      %   %            %     %   %     %
%      %   %            %     %   %     %
%%%%%%%    %%%%%%%%%%%%%%     %   %     %
% S                                     %
%%%%%%%%%%%%%%%%%%%%%%%%%%%%%%%%%%%%%%%%%